./data/terrains/terrain_2.png
####################
#..................#
#..................#
#..##############..#
#..#............#..#
....................
....................
########....########
....................
....................
#..#............#..#
#..##############..#
#..................#
#..................#
####################
