./data/terrains/terrain_1.png
####..##############
#........##........#
#.#####..##...####.#
#........##........#
#..................#
#..................#
....................
....................
....................
....................
#..................#
#..................#
#.....#......#.....#
#.....#......#.....#
####..##############
