./data/terrains/terrain_5.png
######........######
#...##........##...#
#..................#
#........##........#
#...##...##...##...#
#...##........##...#
....................
....................
....................
....##........##....
#...##...##...##...#
#........##........#
#..................#
#...##........##...#
######........######
